00000000000000000000
00001100011101000000
00001000100111010000
00111011101101111010
00100010101011001110
00101010001010000010
00101011111011011110
00111010000001001010
01101111111011001000
01000010101101001010
11110110100101101110
00010111010101000010
01110101010111101111
01000101110000101010
01111101011111101000
01000001000001011100
01111001111111110100
00001100010010100000
00000000011010000000
00000000000000000000
