00000000000000000000
01110101011111100111
00101111001010101010
00101001101010111110
01101001001010000000
00101011011011101110
00111001001010100010
01001101111010110110
01101000000110010010
00101111101100001110
00100000100001110010
01111001111111100010
00101110000000101110
01110000111111110000
00011110100000100110
11010010111110000010
01010110000100111010
01110011111100101110
00100010100111100100
00000000000000000000
