00000000000000000000
00011111111101100110
11010010101000100100
01010000101111111100
01111101001000100110
01001001111010111010
01001000001011001010
01101111011110001000
00100001000010111000
00100011111110100010
01111010010000100010
01001011011000111110
01000010011100000100
01100010010111100110
00001110010000111000
00011000011110001010
00110011100000111111
00100010001111101010
01111110011001001000
00000000000000000000
