00000000000000000000
00001111110100011000
00001001010101010100
01111100001111111000
11010111100000101100
01010100101100100000
01000100111111110000
01000100001000100100
01110001111100111100
01010010001000100100
01010111101000100100
01010100100010010111
00011100100010010000
00000100111110110100
01100100001000011110
00011101101000010100
00000101011111000100
01000101000001111110
01111111110001000000
00000000000000000000
