00000000000000000000
00001011111011111010
00101001001110010010
00111111000000011110
00100101011111110010
01100000010000010110
00110111111111010000
00100100000010010000
00100101111110111100
01110100101000100110
01011101100110100100
00010000000100110111
00010010011100001000
11110011110010111110
00100000010010001010
00111111010010001000
00000101111111111100
01011100000100101010
00110111111100001100
00000000000000000000
