00000000000000000000
00000100111111010000
01111111101000010110
00100000101111111100
00111011100000101000
00100000101100001100
00011100100111100110
11110111110100111010
00010001011100100010
00010101000000111100
01011111111101010111
01010000000000000100
01010111101111011100
01110100111001001000
00100001101101001110
01111100101000001000
00100111101001011100
00000100001111110100
00111111010010010110
00000000000000000000
