00000000000000000000
01100001001011101110
00111111001110011010
00010000100100000000
00011011100110110111
00101000110101010100
00101000011101110100
01111001110010011110
00100000000001110100
00101111101001010110
00101000101001010010
01101001101111000110
01001010100001000100
01101011111111101000
00111000101101001110
00101110101001001000
00101010101001011010
00101010001000010010
11111011000011111110
00000000000000000000
