00000000000000000000
00111111001111000110
00100100111010100100
00101110101000111110
01110101101111100100
00100100000010101100
00101100101110100111
00110111111000101010
01100100101110111010
00100000101010100010
00101110001010111100
00101011111001000010
01101001000001111100
01001001011101010010
01001011001001000100
01001001111111011110
11011000000001010010
01001111111000011100
01111001001111110110
00000000000000000000