00000000000000000000
11011010011001111100
01001111001001001000
01001001011110011110
01111101001001010010
01000001001011110110
00111111011010101100
00100001110010100110
00101111010110100010
01101000011010101100
00101111100010101010
00100001001010101100
01111101111010111000
00010010001010001011
00010110111011101010
01110001001110101010
01011111010000001010
01001001000111011110
01110111111101100010
00000000000000000000