00000000000000000000
00100011001001010100
01111101111111011110
01010100010010100100
01010111111011111110
01011000000100110100
01001111111111010100
01101000100101011000
01011010010101010111
01010111111011010010
01001010101001010110
01101010101111010010
01001010000010010110
11111011111010111010
01001010010011010010
01101100011001011010
01001001110101010010
01101001010111011110
00011111001100100100
00000000000000000000